WWWWWWWWWWWWWWWWWWWWWWWWWWWWWWWWWWWWWWWW
WGGGGGGGGGGGGGGGGGGPPGGGGGGGGGGGGGGGGGGW
WGGGGGGGGGGGGGGGGGGPPGGGGGGGGGGGGGGGGGGW
WGGGGGGGGGGGGGGGGGGPPGGGGGGGGGGGGGGGGGGW
WGGGGGGGGGGGGGGGGGGPPGGGGGGGWWWWWWGGGGGW
WGGGGGGGGGGGGGGGGGGPPGGGGGGGWWWWWWGGGGGW
WGGGGGGGGGGGGGGGGGGPPGGGGGGGWWWWWWGGGGGW
WGGGGGGGGGGGGGGGGGGPPGGGGGGGWWWWWWGGGGGW
WGGGGGGGGGGGGGGGGGGPPGGGGGGGGGGGGGGGGGGW
WGGGGGGGGGGGGGGGGGGPPGGGGGGGGGGGGGGGGGGW
WGGGGGGGGGGGGGGGGGGPPGGGGGGGGGGGGGGGGGGW
WPPPPPPPPPPPPPPPPPPPPPPPPPPPPPPPPPPPPPPW
WPPPPPPPPPPPPPPPPPPPPPPPPPPPPPPPPPPPPPPW
WGGGGGGGGGGGGGGGGGGPPGGGGGGGGGGGGGGGGGGW
WGGGGGGGGGGGGGGGGGGPPGGGGGGGGGGGGGGGGGGW
WGGGGGGGGGGGGGGGGGGPPGGGGGGGGGGGGGGGGGGW
WGGGGGGGGGGGGGGGGGGPPGGGGGGGGGGGGGGGGGGW
WGGGGGGGGGGGGGGGGGGPPGGGGGGGGGGGGGGGGGGW
WGGGGGGGGGGGGGGGGGGPPGGGGGGGGGGGGGGGGGGW
WGGGGGGGGGGGGGGGGGGPPGGGGGGGGGGGGGGGGGGW
WGGGGGGGGGGGGGGGGGGPPGGGGGGGGGGGGGGGGGGW
WGGGGGGGGGGGGGGGGGGPPGGGGGGGGGGGGGGGGGGW
WGGGGGGGGGGGGGGGGGGPPGGGGGGGGGGGGGGGGGGW
WWWWWWWWWWWWWWWWWWWWWWWWWWWWWWWWWWWWWWWW
