WWWWWWWWWWWWWWWWWWWWWWWWWWWWWWWWWWWWWWWWWWWWWWWWWWWWWWWWWWWWWWWWWWWWWWWWWWWWWWWWWWWWWWWWWWWWWWWWWWWW
WGGGGGGGGGGGGGGGGGGGGGGGGGGGGGGGGGGGGGGGGGGGGGGGGWWGGGGGGGGGGGGGGGGGGGGGGGGGGGGGGGGGGGGGGGGGGGGGGGGW
WGGGGGGGGGGGGGGGGGGGGGGGGGGGGGGGGGGGGGGGGGGGGGGGGWWGGGGGGGGGGGGGGGGGGGGGGGGGGGGGGGGGGGGGGGGGGGGGGGGW
WGGGGGGGGGGGGGGGGGGGGGGGGGGGGGGGGGGGGGGGGGGGGGGGGWWGGGGGGGGGGGGGGGGGGGGGGGGGGGGGGGGGGGGGGGGGGGGGGGGW
WGGGGGGGGGGGGGGGGGGGGGGGGGGGGGGGGGGGGGGGGGGGGGGGGWWGGGGGGGGGGGGGGGGGGGGGGGGGGGGGGGGGGGGGGGGGGGGGGGGW
WGGGGGGGGGGGGGGGGGGGGGGGGGGGGGGGGGGGGGGGGGGGGGGGGWWGGGGGGGGGGGGGGGGGGGGGGGGGGGGGGGGGGGGGGGGGGGGGGGGW
WGGGGGGGGGGGGGGGGGGGGGGGGGGGGGGGGGGGGGGGGGGGGGGGGWWGGGGGGGGGGGGGGGGGGGGGGGGGGGGGGGGGGGGGGGGGGGGGGGGW
WGGGGGGGGGWWWWWWGGGGGGGGGGGGGGGGGGWWWWWWGGGGGGGGGWWGGGGGGGGGWWWWWWGGGGGGGGGGGGGGGGGGWWWWWWGGGGGGGGGW
WGGGGGGGGGWWWWWWGGGGGGGGGGGGGGGGGGWWWWWWGGGGGGGGGWWGGGGGGGGGWWWWWWGGGGGGGGGGGGGGGGGGWWWWWWGGGGGGGGGW
WGGGGGGGGGGGGGGGGGGGGGGGPPGGGGGGGGGGGGGGGGGGGGGGGWWGGGGGGGGGGGGGGGGGGGGGGGPPGGGGGGGGGGGGGGGGGGGGGGGW
WGGGGGGGGGGGGGGGGGGGGGGGPPGGGGGGGGGGGGGGGGGGGGGGGWWGGGGGGGGGGGGGGGGGGGGGGGPPGGGGGGGGGGGGGGGGGGGGGGGW
WPPPPPPPPPPPPPPPPPPPPPPPPPPPPPPPPPPPPPPPPPPPPPPPPWWPPPPPPPPPPPPPPPPPPPPPPPPPPPPPPPPPPPPPPPPPPPPPPPPW
WPPPPPPPPPPPPPPPPPPPPPPPPPPPPPPPPPPPPPPPPPPPPPPPPWWPPPPPPPPPPPPPPPPPPPPPPPPPPPPPPPPPPPPPPPPPPPPPPPPW
WGGGGGGGGGGGGGGGGGGGGGGGPPGGGGGGGGGGGGGGGGGGGGGGGWWGGGGGGGGGGGGGGGGGGGGGGGPPGGGGGGGGGGGGGGGGGGGGGGGW
WGGGGGGGGGGGGGGGGGGGGGGGPPGGGGGGGGGGGGGGGGGGGGGGGWWGGGGGGGGGGGGGGGGGGGGGGGPPGGGGGGGGGGGGGGGGGGGGGGGW
WGGGGGGGGGGGGGGGGGGGGGGGPPGGGGGGGGGGGGGGGGGGGGGGGWWGGGGGGGGGGGGGGGGGGGGGGGPPGGGGGGGGGGGGGGGGGGGGGGGW
WGGGGGGGGGGGGGGGGGGGGGGGPPGGGGGGGGGGGGGGGGGGGGGGGWWGGGGGGGGGGGGGGGGGGGGGGGPPGGGGGGGGGGGGGGGGGGGGGGGW
WGGGGGGGGGWWWWWWGGGGGGGGPPGGGGGGGGWWWWWWGGGGGGGGGWWGGGGGGGGGWWWWWWGGGGGGGGPPGGGGGGGGWWWWWWGGGGGGGGGW
WGGGGGGGGGWWWWWWGGGGGGGGPPGGGGGGGGWWWWWWGGGGGGGGGWWGGGGGGGGGWWWWWWGGGGGGGGPPGGGGGGGGWWWWWWGGGGGGGGGW
WGGGGGGGGGGGGGGGGGGGGGGGPPGGGGGGGGGGGGGGGGGGGGGGGWWGGGGGGGGGGGGGGGGGGGGGGGPPGGGGGGGGGGGGGGGGGGGGGGGW
WGGGGGGGGGGGGGGGGGGGGGGGPPGGGGGGGGGGGGGGGGGGGGGGGWWGGGGGGGGGGGGGGGGGGGGGGGPPGGGGGGGGGGGGGGGGGGGGGGGW
WGGGGGGGGGGGGGGGGGGGGGGGPPGGGGGGGGGGGGGGGGGGGGGGGWWGGGGGGGGGGGGGGGGGGGGGGGPPGGGGGGGGGGGGGGGGGGGGGGGW
WGGGGGGGGGGGGGGGGGGGGGGGPPGGGGGGGGGGGGGGGGGGGGGGGWWGGGGGGGGGGGGGGGGGGGGGGGPPGGGGGGGGGGGGGGGGGGGGGGGW
WGGGGGGGGGGGGGGGGGGGGGGGGGGGGGGGGGGGGGGGGGGGGGGGGWWGGGGGGGGGGGGGGGGGGGGGGGGGGGGGGGGGGGGGGGGGGGGGGGGW
WGGGGGGGGGGGGGGGGGGGGGGGGGGGGGGGGGGGGGGGGGGGGGGGGWWGGGGGGGGGGGGGGGGGGGGGGGGGGGGGGGGGGGGGGGGGGGGGGGGW
WGGGGGGGGGGGGGGGGGGGGGGGGGGGGGGGGGGGGGGGGGGGGGGGGWWGGGGGGGGGGGGGGGGGGGGGGGGGGGGGGGGGGGGGGGGGGGGGGGGW
WGGGGGGGGGGGGGGGGGGGGGGGGGGGGGGGGGGGGGGGGGGGGGGGGWWGGGGGGGGGGGGGGGGGGGGGGGGGGGGGGGGGGGGGGGGGGGGGGGGW
WWWWWWWWWWWWWWWWWWWWWWWWWWWWWWWWWWWWWWWWWWWWWWWWWWWWWWWWWWWWWWWWWWWWWWWWWWWWWWWWWWWWWWWWWWWWWWWWWWWW
WWWWWWWWWWWWWWWWWWWWWWWWWWWWWWWWWWWWWWWWWWWWWWWWWWWWWWWWWWWWWWWWWWWWWWWWWWWWWWWWWWWWWWWWWWWWWWWWWWWW
WGGGGGGGGGGGGGGGGGGGGGGGGGGGGGGGGGGGGGGGGGGGGGGGGWWGGGGGGGGGGGGGGGGGGGGGGGGGGGGGGGGGGGGGGGGGGGGGGGGW
WGGGGGGGGGGGGGGGGGGGGGGGGGGGGGGGGGGGGGGGGGGGGGGGGWWGGGGGGGGGGGGGGGGGGGGGGGGGGGGGGGGGGGGGGGGGGGGGGGGW
WGGGGGGGGGGGGGGGGGGGGGGGGGGGGGGGGGGGGGGGGGGGGGGGGWWGGGGGGGGGGGGGGGGGGGGGGGGGGGGGGGGGGGGGGGGGGGGGGGGW
WGGGGGGGGGGGGGGGGGGGGGGGGGGGGGGGGGGGGGGGGGGGGGGGGWWGGGGGGGGGGGGGGGGGGGGGGGGGGGGGGGGGGGGGGGGGGGGGGGGW
WGGGGGGGGGGGGGGGGGGGGGGGGGGGGGGGGGGGGGGGGGGGGGGGGWWGGGGGGGGGGGGGGGGGGGGGGGGGGGGGGGGGGGGGGGGGGGGGGGGW
WGGGGGGGGGGGGGGGGGGGGGGGGGGGGGGGGGGGGGGGGGGGGGGGGWWGGGGGGGGGGGGGGGGGGGGGGGGGGGGGGGGGGGGGGGGGGGGGGGGW
WGGGGGGGGGWWWWWWGGGGGGGGGGGGGGGGGGWWWWWWGGGGGGGGGWWGGGGGGGGGWWWWWWGGGGGGGGGGGGGGGGGGWWWWWWGGGGGGGGGW
WGGGGGGGGGWWWWWWGGGGGGGGGGGGGGGGGGWWWWWWGGGGGGGGGWWGGGGGGGGGWWWWWWGGGGGGGGGGGGGGGGGGWWWWWWGGGGGGGGGW
WGGGGGGGGGGGGGGGGGGGGGGGPPGGGGGGGGGGGGGGGGGGGGGGGWWGGGGGGGGGGGGGGGGGGGGGGGPPGGGGGGGGGGGGGGGGGGGGGGGW
WGGGGGGGGGGGGGGGGGGGGGGGPPGGGGGGGGGGGGGGGGGGGGGGGWWGGGGGGGGGGGGGGGGGGGGGGGPPGGGGGGGGGGGGGGGGGGGGGGGW
WPPPPPPPPPPPPPPPPPPPPPPPPPPPPPPPPPPPPPPPPPPPPPPPPWWPPPPPPPPPPPPPPPPPPPPPPPPPPPPPPPPPPPPPPPPPPPPPPPPW
WPPPPPPPPPPPPPPPPPPPPPPPPPPPPPPPPPPPPPPPPPPPPPPPPWWPPPPPPPPPPPPPPPPPPPPPPPPPPPPPPPPPPPPPPPPPPPPPPPPW
WGGGGGGGGGGGGGGGGGGGGGGGPPGGGGGGGGGGGGGGGGGGGGGGGWWGGGGGGGGGGGGGGGGGGGGGGGPPGGGGGGGGGGGGGGGGGGGGGGGW
WGGGGGGGGGGGGGGGGGGGGGGGPPGGGGGGGGGGGGGGGGGGGGGGGWWGGGGGGGGGGGGGGGGGGGGGGGPPGGGGGGGGGGGGGGGGGGGGGGGW
WGGGGGGGGGGGGGGGGGGGGGGGPPGGGGGGGGGGGGGGGGGGGGGGGWWGGGGGGGGGGGGGGGGGGGGGGGPPGGGGGGGGGGGGGGGGGGGGGGGW
WGGGGGGGGGGGGGGGGGGGGGGGPPGGGGGGGGGGGGGGGGGGGGGGGWWGGGGGGGGGGGGGGGGGGGGGGGPPGGGGGGGGGGGGGGGGGGGGGGGW
WGGGGGGGGGWWWWWWGGGGGGGGPPGGGGGGGGWWWWWWGGGGGGGGGWWGGGGGGGGGWWWWWWGGGGGGGGPPGGGGGGGGWWWWWWGGGGGGGGGW
WGGGGGGGGGWWWWWWGGGGGGGGPPGGGGGGGGWWWWWWGGGGGGGGGWWGGGGGGGGGWWWWWWGGGGGGGGPPGGGGGGGGWWWWWWGGGGGGGGGW
WGGGGGGGGGGGGGGGGGGGGGGGPPGGGGGGGGGGGGGGGGGGGGGGGWWGGGGGGGGGGGGGGGGGGGGGGGPPGGGGGGGGGGGGGGGGGGGGGGGW
WGGGGGGGGGGGGGGGGGGGGGGGPPGGGGGGGGGGGGGGGGGGGGGGGWWGGGGGGGGGGGGGGGGGGGGGGGPPGGGGGGGGGGGGGGGGGGGGGGGW
WGGGGGGGGGGGGGGGGGGGGGGGPPGGGGGGGGGGGGGGGGGGGGGGGWWGGGGGGGGGGGGGGGGGGGGGGGPPGGGGGGGGGGGGGGGGGGGGGGGW
WGGGGGGGGGGGGGGGGGGGGGGGPPGGGGGGGGGGGGGGGGGGGGGGGWWGGGGGGGGGGGGGGGGGGGGGGGPPGGGGGGGGGGGGGGGGGGGGGGGW
WGGGGGGGGGGGGGGGGGGGGGGGGGGGGGGGGGGGGGGGGGGGGGGGGWWGGGGGGGGGGGGGGGGGGGGGGGGGGGGGGGGGGGGGGGGGGGGGGGGW
WGGGGGGGGGGGGGGGGGGGGGGGGGGGGGGGGGGGGGGGGGGGGGGGGWWGGGGGGGGGGGGGGGGGGGGGGGGGGGGGGGGGGGGGGGGGGGGGGGGW
WGGGGGGGGGGGGGGGGGGGGGGGGGGGGGGGGGGGGGGGGGGGGGGGGWWGGGGGGGGGGGGGGGGGGGGGGGGGGGGGGGGGGGGGGGGGGGGGGGGW
WGGGGGGGGGGGGGGGGGGGGGGGGGGGGGGGGGGGGGGGGGGGGGGGGWWGGGGGGGGGGGGGGGGGGGGGGGGGGGGGGGGGGGGGGGGGGGGGGGGW
WWWWWWWWWWWWWWWWWWWWWWWWWWWWWWWWWWWWWWWWWWWWWWWWWWWWWWWWWWWWWWWWWWWWWWWWWWWWWWWWWWWWWWWWWWWWWWWWWWWW
